1111111111111111111111111111111111111111
1P0000000000000C000000000000000000000001
1011111101111101011111010111110101010101
1000000100000000010000010000000100010001
1011101110111110111011101111110111011101
1000100000100000001000010000000100000001
1110111110101111101011111011110101111101
1000000000100000101000001000010000000001
1011111110111110101111101011111110111101
1000000000000010000000100000000000000001
1011101111111011111010111110111111110101
1000100000000000000010000000000000010001
1111111101111111111010111111111111111101
1000000100000000000000000000000000000001
1011111110111111111110111111101111111101
1000000000100000000010000000100000000001
1011111111101111111011111011110111111101
100000000000000C000000000000000C00000001
11111111111111111111111111111111111111E1
1111111111111111111111111111111111111111
