11111111111
1P0000000E1
11111111111
1000C000011
11111111111