1111111
1P00001
1000C01
1000E01
1111111
1000001
