11111111
1P0C0001
100C0001
1000E001
1000C001
00000001
