11111111
1P0C0001
100X0001
1000E001
1000C001
11111111
