11111
1P0C1
10001
100C1
11111
