1111111111
1P0000000E
1000000001
1000C00001
1111111110